{11111111111111111111111111111111}
{10222220000000000000000000000201}
{10000220000000000000000000000001}
{10000000000000000000000012030001}
{10000000000000000000000012030001}
{10000000000000000000000012030001}
{10000000000000000000000001110001}
{10011100000000000000000000000001}
{10000000000000000000000000000001}
{12000000000000000000000000000001}
{12000000000000000000000000000001}
{12000000000000000000000000300001}
{12000000000000330000000000330001}
{12000000000000223000000000000001}
{12000000000000000000000000000001}
{10000000000022000000000000000001}
{10000000000222200000000000000001}
{11111111111111111111111111111111}